######################################
#.@...#.....#........#.....#.........#
#.....###...#........#.....#.........#
#..#........#..####..#.....#....#....#
#..#...........#................#....#
##########.....#..####..##############
#........#.....#.....................#
#........#.....#..###########........#
#..#############.......#.......#####.#
#..#...#.......#.......#.......#.....#
#..#...#.......#...............#.....#
#..#...#....########################.#
#..#...#.............................#
#..#...#..#..........................#
#......#..#..........................#
#......#..#..........................#
#..#####..#...#########..............#
#.........#...#.......#.....##########
#.........#...#....#..#.....#........#
########..#####....####..#..#...#....#
#.........#..............#..#...#....#
#.........#..............#......#....#
######################################