######################################
#....................................#
#....................................#
########.............................#
#....................................#
#....................................#
#....................................#
#....................................#
#....................................#
#...........................##########
#....................................#
#....................................#
#....................................#
#....................................#
#....................................#
#....................................#
#....................................#
#....................................#
#....................................#
#.......#######################......#
#....................................#
#....................................#
######################################